######
#    #
# OB #
#    #
#  X #
######

