######
#    #
# OB #
# BX #
#  X #
######

