########
####X  #
# O B  #
#   B  #
#   #X #
########

