######
#    #
#O   #
# B# #
#  # #
#BB# #
#XXX #
######
